WE ./path_to_the_west_texture
SO ./path_to_the_south_texture
NO ./path_to_the_north_texture
EA ./path_to_the_east_texture

F 220,100,0
C 255,30,0

111111111111111
100000000000001
100001111110001
110000000010001
100111111110001
100111100000001
100000000N00001
111111111111111
