WE ./path_to_the_west_texture
SO ./path_to_the_south_texture
NO ./path_to_the_north_texture
EA ./path_to_the_east_texture

F 220,100,0
C 255,30,0

11111111111111111111111111111111111111
10000000000000111111111000000000000011
10000111111000000000000000011111100011
11000000001000111111111100000000100011
10011111111000111111111001111111100011
10011110000000111111111001111000000011
100000000N0000111111111000000000000011
11111111111111111111111111111111111111
