NO ./img/wall_n.xpm
SO ./img/wall_s.xpm
WE ./img/wall_w.xpm
EA ./img/wall_e.xpm
F 102,102,000
C 000,204,255

1111111111111111111111111111
1000010010000010000010000001
1010000010000010000000000001
1000011010000010000000000001
1010000000000100000100000001
1010000010000000000100000001
1000S01000000010000010000001
1000011010000000000000000001
1000011010000000000000000001
1000001000000010000000000001
1000011010000000000000000001
1000011010000010000000000001
1000000000000011111111111111
1000011010000000000000000001
1111111111111111111111111111
