NO ./img/wall_n.xpm
SO ./img/wall_s.xpm
WE ./img/wall_w.xpm
EA ./img/wall_e.xpm
F 220,100,0
C 255,30,0

11111111
10000101
10100001
10000111
10100001
10100001
1000N011
11111111
